00000000000000000000000000
01110111011101111111111110
01111111011101111111111110
01110111011001111111111110
00100000011101111111111110
01110111111001111111111110
01110111011101111111111110
01111111011001111111111110
01110111011101111111111110
00000110000001111111111110
01110110111111111111111110
01110111111011111111111110
01110110011111111111111110
01111111011011111111111110
01110111011111111111111110
00000000000000000000000000